		
  R   	650 	500
 
   SO ./img/redbrick.xpm 
NO ./img/colorstone.xpm
	WE ./img/door.xpm 
EA ./img/telep.xpm


S ./img/pics/barrel.xpm 

F  255 , 200,  90
C 	0,0,0


111111111111111111111
100000002010000000001		
100020000000000000001		
100000011111111111001		
10000001    100000001			
10000001    100000001   11111111111111111111111
10000001    100000001   10000000000000000000001
102000011111100000001   11000000000000000000001
100000000000000000001    1000000000000000000001
10000000000000000000111111000000000000000000001	
11111100000000000000000000000000000000000000001	
1000000020002000000000000000000000000000000000111111		
1000000020002000000000000000000000000000000000000001		
1000000020002000000000000000000000000000000000000001	
1000000020002000000000000000000000000000000000000001		
1000000020002000000011111100000000000000000000000001	
100000002000200000001    100000000000000000000000001	
111111111000111111111    100000000000000000000000001
        10001            111111111111110011111111111
        10001                         1001
        10001                         1001
        10001                         1001
        10001                         1001
111111111000111111111                 1001
100000000000000000001            1111110011111
100200000000000000001            1000000000001			
100000000000000000001            10000000000011
100000000000000000001            11110000000001
100000000000000000001            10000000000001
100000000200000000001            10000000000001
100000000000000000001            10000000000001
100000000000000000001            10000000000001
100000000000000020001   11111111110000000000001
10000000000000000000111110000000000000000000001
10000000000000000000000000000000000000000000001
1111111100001111111111111111111111111000011111111
100000000000000000000000000000000000000000000000111111111111111111111
100000000000000000000000000000000000000000000000000000000000000000001
100000000000000000000000000000000000000000000000000000000000000000001
100000000000000000000000000000000000000000000000000000000000000000001
100000000000000000000000000000000000000000000000000000000000000000001
100000000000000000000000000000000000000000000000000000000000000000001
100000000000000000000000000000000000000000000000000000000000000000001
100000000000000000000000000000000000000000000000000000000000000000001
100000000000000000000000000000002000000000000000000000000000000000001
100001111110111110000000000000002000000000000000000000000000000000001
100001000000000010000000000000002000000000000000000000000000000000001
100001000000000010000000000000002000000000000000000000000000000000001
100001020000000010000000000000002000000000000000000000000000000000001
100001000000000010000000000000002000000000000000000000000000000000001
100001111111111110000000000000000000000000000000000000000000000000001
100000000000000000000000000000000000000000000000000000000000000000001
100000000000000000000000000000000000000000000000000000000000000000001
100000000000000000000000000000000000000000000000000000000000000000001
100000000000000000000000000000000000000000000000000000000000000000001
100000000000000000000000000000000000000000000000000000000W00000000001
100000000000000000000000000000000000000000000000000000000000000000001
100000000000000000000000000000000000000000000000000000000000000000001
100000000000000000000000000000000000000000000000000000000000000000001
111111111111111111111111111111111111111111111111111111111111111111111

		
		

    
			