R 650  500

NO ./img/img.xpm
SO ./img/img.xpm
WE ./img/stone1.xpm
EA ./img/stone1.xpm

S ./img/pics/pilar.xpm
F 0,254,255  
C 0,150,150


111111111111111111111111111111
100000000000020000000000000001
100000000000000000000000000201
100000000000000000000000000001
100000000000000000000000000001
100000000001111111111111111111
100000000001
100000000001
100002000001
100000000101       1111
100000000101       1001
1000N0001001       1001
1000001111001      1001
10100210000011111111111111111
10100010200000000000000000001
10111110000000000000000000001
1111111111111111111111100000111111
                      100000000001
                      100000000001
                      100000020001
                      111111111111
