R 1000  1200

NO ./img/img.xpm
SO ./img/img.xpm
WE ./img/img.xpm
EA ./img/img.xpm

S ./img/pics/pillar.xpm
F 0,254,255  
C 0,150,150


11111111111111111111111111111111111
10000000000000000020000000000000001
10000000S00000000000000000000000201
10000000000000000000000000000000001
10000000000000000000000000000000001
10000000000011111111111111111111111
1000000000001
1000000000001
1000020000001
1000000001001
1000000001001
1000000001001
1000001111001
1010021000001111111111111111111111
1010001020000000000000000000000001
1011111000000000000000000000000001
1111111111111111111111100000020001
		      100000000001
                      100000000001
		      100000020001
                      111111111111
