R 1000 1200

NO ./img/img.xpm
NO ./img/img.xpm
SO ./img/img.xpm
WE ./img/img.xpm
EA ./img/img.xpm

S ./img/pics/pillar.xpm

F 0,254,255
C 0,255,120

1111111111111
1000000000001
1000020000001
100000N001001
1000000001001
1000000001001
1000001111001
1010021000001
1010001020001
1011111000001
1111111111111